sprite0:frog.txt
sprite1:plant1.txt
 :data/water_tile_64.png
1:data/leaf_tile_64.png
== comment
1         1         1         1         
 1  1 1 1    1 1    1 1    1 1    1     
    1 1 1  1  1 1  1    1 1 1  1  1     
   1          1         1         1     
     1 1       1 1       1 1       1 1  
               1 1       1 1       1 1  
   1   1       1 1       1 1       1 1  
               1 1       1 1       1 1  
1         1         1         1         
          1         1         1         
          1         1         1         
          1         1         1         
          1         1         1         
          1         1         1         
   1      1         1         1         
== comment